1 2 3 2 1 2 1 2 3 2
1 2 1 2 1 2 1 2 1 2
1 2 3 2 1 2 1 2 3 2
0 2 0 2 0 2 0 2 0 2
1 2 3 2 1 2 1 2 3 2